~~~~S~~~~~~~~~~~~~~
~~~~~~~~~~~~~~~~~~~
~~~~~          ~~~~
~~~~            ~~~
########   ~~~~~~~~
             ######
      #      #~~~~~
###### # #####~~~~~
     # #      ~~~~~
 # # ###### ####~~~
 #          #~~~~~~
     ### ####~~~~~~
                  E