~~~~~~~~~~~~~~~~~~~
~~~~~~~~~~~~~~~~~~~
~~~~~          ~~~~
~~~~            ~~~
########   ~~~~~~~~
             ######
      S      #~~~~~
###### # #####~~~~~
     # #      ~~~~~
 # # ###### ####~~~
 #          #~~~~~~
     ### ####~~~~~~
                  E